20
100
13 0 0 0 0 0 0 0 0 0 0 0 0 0 0 0 0 0 0 13 
13 0 0 0 0 0 0 0 0 0 0 0 0 0 0 0 0 0 0 13 
13 0 0 0 0 0 0 0 0 0 0 0 0 0 0 0 0 0 0 13 
13 0 0 0 0 0 0 0 0 0 0 0 0 0 0 0 0 0 0 13 
13 0 0 0 0 0 0 0 0 0 0 0 0 0 0 0 0 0 0 13 
13 0 0 0 0 0 0 0 0 0 0 0 0 0 0 0 0 0 0 13 
13 0 0 0 0 0 0 0 0 0 0 0 0 0 0 0 0 0 0 13 
13 0 0 0 0 0 0 0 0 0 0 9 0 0 0 0 0 0 0 13 
13 11 11 11 11 12 0 0 0 10 11 12 0 0 0 0 10 11 11 13 
13 0 0 0 0 0 0 0 0 0 0 0 0 0 0 0 0 0 0 13 
13 0 0 0 0 0 0 0 0 0 0 0 0 0 0 0 0 0 0 13 
13 0 0 0 0 0 0 0 0 0 0 0 0 0 0 0 9 0 0 13 
13 0 0 0 0 0 0 0 0 0 0 0 10 11 11 11 12 0 0 13 
13 0 0 0 0 0 0 0 0 0 0 0 0 0 0 0 0 0 0 13 
13 0 0 10 11 11 11 12 0 0 0 0 0 0 0 0 0 0 0 13 
13 0 0 0 0 0 0 13 12 0 0 0 0 0 0 0 0 0 0 13 
13 0 0 9 0 0 0 0 13 12 0 0 0 0 0 10 11 11 11 13 
13 11 11 12 0 0 0 0 0 13 12 0 0 0 10 13 0 0 0 13 
13 0 0 0 0 0 0 0 0 0 13 11 11 11 13 0 0 0 0 13 
13 0 0 0 0 0 0 0 0 0 0 0 0 0 0 0 0 0 0 13 
13 0 0 0 0 0 0 0 0 0 0 0 0 0 0 0 0 0 0 13 
13 0 0 0 0 0 0 0 0 0 0 0 0 0 0 0 0 0 0 13 
13 0 0 0 0 0 0 0 0 0 0 0 0 0 0 0 0 0 0 13 
13 0 0 0 0 0 0 0 0 0 0 0 0 0 0 0 0 0 0 13 
13 0 0 0 0 0 0 0 0 0 0 0 0 0 0 0 0 0 0 13 
11 11 11 11 11 11 12 0 0 0 0 0 0 0 0 0 0 0 0 13 
13 0 0 0 0 0 0 0 0 0 0 0 0 0 0 0 0 0 0 13 
13 0 0 0 0 0 0 0 0 0 0 0 0 0 0 0 0 0 0 13 
13 0 0 0 0 10 12 0 0 0 0 0 0 0 0 0 0 0 0 13 
13 0 0 0 0 0 0 0 0 0 0 0 0 0 0 0 0 0 0 13 
13 0 0 0 0 0 0 0 0 0 0 0 0 0 0 0 0 0 0 13 
13 0 0 0 0 10 12 0 0 0 0 0 0 0 0 0 0 0 0 13 
13 0 0 0 0 0 0 0 0 0 0 0 0 0 0 0 0 0 0 13 
13 0 0 0 0 0 0 0 0 0 0 0 0 9 0 0 0 0 0 13 
13 0 0 0 0 0 0 0 10 12 0 0 10 12 0 0 0 0 0 13 
13 0 0 0 0 0 0 0 0 0 0 0 0 0 0 0 9 0 0 13 
13 0 0 0 0 0 0 0 0 0 0 0 0 0 0 10 12 0 0 13 
13 0 0 0 0 0 0 0 0 0 0 0 0 0 0 0 0 0 0 13 
13 0 0 0 0 0 0 0 0 0 0 10 12 0 0 0 0 0 0 13 
13 0 0 0 0 0 0 0 0 0 0 0 0 0 0 0 0 0 0 13 
13 0 0 0 0 0 0 0 0 0 0 0 0 0 0 10 11 11 11 13 
13 0 0 0 0 0 0 0 0 0 0 0 0 0 0 0 0 0 0 13 
13 0 0 0 0 0 0 0 0 0 0 0 0 0 0 0 0 0 0 13 
13 0 0 0 0 0 0 0 0 0 0 0 10 12 0 0 0 0 0 13 
13 0 0 0 0 0 0 0 0 0 0 0 0 0 0 0 0 0 0 13 
13 0 0 0 0 0 0 0 0 0 0 0 0 0 0 0 0 0 0 13 
13 0 0 0 0 0 0 0 0 0 0 0 0 0 0 0 0 0 0 13 
13 0 0 0 0 0 0 0 0 0 0 0 10 12 0 0 0 0 0 13 
13 0 0 0 0 0 0 0 0 0 0 0 0 0 0 0 0 0 11 13 
13 0 0 0 0 0 0 0 0 0 0 0 0 0 0 0 0 0 0 13 
13 0 0 0 0 0 0 0 0 0 0 0 0 0 0 0 0 0 0 13 
13 0 0 0 0 0 0 0 0 0 0 0 0 0 0 10 12 0 0 13 
13 0 0 0 0 0 0 0 0 0 0 0 0 0 0 0 0 0 0 13 
13 0 0 0 0 0 0 0 0 0 0 0 0 0 0 0 0 0 0 13 
11 11 11 11 11 11 11 11 11 11 11 11 11 11 11 11 11 11 11 13 
0 0 0 0 0 0 0 0 0 0 0 0 0 0 0 0 0 0 0 0 
0 0 0 0 0 0 0 0 0 0 0 0 0 0 0 0 0 0 0 0 
0 0 0 0 0 0 0 0 0 0 0 0 0 0 0 0 0 0 0 0 
0 0 0 0 0 0 0 0 0 0 0 0 0 0 0 0 0 0 0 0 
0 0 0 0 0 0 0 0 0 0 0 0 0 0 0 0 0 0 0 0 
0 0 0 0 0 0 0 0 0 0 0 0 0 0 0 0 0 0 0 0 
0 0 0 0 0 0 0 0 0 0 0 0 0 0 0 0 0 0 0 0 
0 0 0 0 0 0 0 0 0 0 0 0 0 0 0 0 0 0 0 0 
0 0 0 0 0 0 0 0 0 0 0 0 0 0 0 0 0 0 0 0 
0 0 0 0 0 0 0 0 0 0 0 0 0 0 0 0 0 0 0 0 
0 0 0 0 0 0 0 0 0 0 0 0 0 0 0 0 0 0 0 0 
0 0 0 0 0 0 0 0 0 0 0 0 0 0 0 0 0 0 0 0 
0 0 0 0 0 0 0 0 0 0 0 0 0 0 0 0 0 0 0 0 
0 0 0 0 0 0 0 0 0 0 0 0 0 0 0 0 0 0 0 0 
0 0 0 0 0 0 0 0 0 0 0 0 0 0 0 0 0 0 0 0 
0 0 0 0 0 0 0 0 0 0 0 0 0 0 0 0 0 0 0 0 
0 0 0 0 0 0 0 0 0 0 0 0 0 0 0 0 0 0 0 0 
0 0 0 0 0 0 0 0 0 0 0 0 0 0 0 0 0 0 0 0 
0 0 0 0 0 0 0 0 0 0 0 0 0 0 0 0 0 0 0 0 
0 0 0 0 0 0 0 0 0 0 0 0 0 0 0 0 0 0 0 0 
0 0 0 0 0 0 0 0 0 0 0 0 0 0 0 0 0 0 0 0 
0 0 0 0 0 0 0 0 0 0 0 0 0 0 0 0 0 0 0 0 
0 0 0 0 0 0 0 0 0 0 0 0 0 0 0 0 0 0 0 0 
0 0 0 0 0 0 0 0 0 0 0 0 0 0 0 0 0 0 0 0 
0 0 0 0 0 0 0 0 0 0 0 0 0 0 0 0 0 0 0 0 
0 0 0 0 0 0 0 0 0 0 0 0 0 0 0 0 0 0 0 0 
0 0 0 0 0 0 0 0 0 0 0 0 0 0 0 0 0 0 0 0 
0 0 0 0 0 0 0 0 0 0 0 0 0 0 0 0 0 0 0 0 
0 0 0 0 0 0 0 0 0 0 0 0 0 0 0 0 0 0 0 0 
0 0 0 0 0 0 0 0 0 0 0 0 0 0 0 0 0 0 0 0 
0 0 0 0 0 0 0 0 0 0 0 0 0 0 0 0 0 0 0 0 
0 0 0 0 0 0 0 0 0 0 0 0 0 0 0 0 0 0 0 0 
0 0 0 0 0 0 0 0 0 0 0 0 0 0 0 0 0 0 0 0 
0 0 0 0 0 0 0 0 0 0 0 0 0 0 0 0 0 0 0 0 
0 0 0 0 0 0 0 0 0 0 0 0 0 0 0 0 0 0 0 0 
0 0 0 0 0 0 0 0 0 0 0 0 0 0 0 0 0 0 0 0 
0 0 0 0 0 0 0 0 0 0 0 0 0 0 0 0 0 0 0 0 
0 0 0 0 0 0 0 0 0 0 0 0 0 0 0 0 0 0 0 0 
0 0 0 0 0 0 0 0 0 0 0 0 0 0 0 0 0 0 0 0 
0 0 0 0 0 0 0 0 0 0 0 0 0 0 0 0 0 0 0 0 
0 0 0 0 0 0 0 0 0 0 0 0 0 0 0 0 0 0 0 0 
0 0 0 0 0 0 0 0 0 0 0 0 0 0 0 0 0 0 0 0 
0 0 0 0 0 0 0 0 0 0 0 0 0 0 0 0 0 0 0 0 
0 0 0 0 0 0 0 0 0 0 0 0 0 0 0 0 0 0 0 0 
0 0 0 0 0 0 0 0 0 0 0 0 0 0 0 0 0 0 0 0 
