10
10
13 13 13 13 13 13 13 13 13 13 
13 0 0 0 0 0 0 0 0 13 
13 0 0 0 0 0 0 0 0 13 
13 0 0 0 0 0 0 0 0 13 
13 0 0 0 0 0 0 0 0 13 
13 11 0 0 0 0 0 0 11 13 
13 0 0 0 0 0 0 0 0 13 
13 0 0 0 0 0 0 0 0 13 
13 0 0 0 0 0 0 0 0 13 
13 11 11 11 11 11 11 11 11 13 
